####################
#p  ***            #
#** ###  ##  ###** #
#   #        * #   #
# **#  * * * * # **#
#   *b         *   #
#** # * * * *  #** #
#   *o        b*   #
# **#  * * * * # **#
#   *b        o*   #
#** # * * * *  #** #
#   # *       b#   #
# **###  ##  ### **#
#            ***  x#
####################