####################
#p  *i*            #
#** ###  ##  ###** #
#   #b       * #   #
# **#  * * * * # i*#
#   *b        b*   #
#** # * * * *  #** #
#   ib        b*   #
# **#  * * * * # **#
#   *b        b*   #
#** # i * * *  #** #
#   # *       b#   #
# **###  ##  ### **#
#            *i*  x#
####################