####################
#   ***            #
#   ###  ##  ###** #
#   #        * #   #
#   #          # **#
#   * x      x *   #
#   #b         #** #
#   * * *  * * *   #
#   #         b# **#
#   * x      x *   #
#   #b         #** #
#   # *       b#   #
#   ###  ##  ### **#
#            ***  b#
####################