####################
#   *              #
#   ###  ##  ###   #
#   #          #   #
#   #          #   #
#   * x      x *   #
#   #          #   #
#   * * *  * * *   #
#   #          #   #
#   * x      x *   #
#   #          #   #
#   #          #   #
#   ### ###  ###   #
#              *   #
####################