####################
#p   **  *   ***   #
# # #*#  ##  ###*# #
#   *    *** * * * #
# # #*# # #*#*# #**#
#   *     **b   *  #
# # # # # # # # #  #
#   *          *   #
# **###*#*#*#* #** #
#   *         b*   #
#*# # **### *  #   #
#*    *b       * **#
#*#*# #**##  ###  b#
#    *       ***  x#
####################