####################
#   *  b  #  b  *  #
# **#* #  #  # *#* #
#   *  #  #  #  *  #
#** # *#* # *#* # *#
#   #  *  b  *  #  #
# **#* ** b ** *#* #
#   *  ** b **  *  #
#** # **  b  ** # *#
#   #  *  #  *  #  #
# **** ** # ** *** #
#   #b #  #  # b#  #
#** # *# *#* #* #  #
#      #  x  #     #
####################