####################
#p  *  b  #  b  *  #
# **#* # *#* # i#* #
#   *  #  #  #  *  #
#i* # *#* # *#* # *#
#   #  *  b  *  #  #
# **#* ** b i* *#* #
#   *  ** b **  *  #
#** # **  b  ** # *#
#   #  *  #  *  #  #
# **i* ** # ** *i* #
#   #b #  #  # b#  #
#** # *# *#* #* #  #
#      #     #     #
####################