####################
#    *  *  *o   *  #
# # #* #**#  # *#* #
#   *b ** *  * o*  #
# # # *#* # *#* # *#
#   #  #    *   #  #
# #*#* *#*# #*# #* #
#  *#   **b **  *  #
#*# #  *# # #** # *#
#   #  *  #  *  #  #
# #*** ** # ** *** #
#   #b #  #  # b#  #
#*# # *# *#* #* #  #
#      #  x  #b    #
####################