####################
# * * * *bb* * * * #
# # # # # # # # # *#
# * * * *bb* * * * #
#* # # # # # # # # #
# * * * *bb* * * * #
# # # # # # # # # *#
# * * * *bb* * * * #
#* # # # # # # # # #
# * * * *bb* * * * #
# # # # # # # # # *#
# * * * *bb* * * * #
#* # # # # # # # # #
#x* * * *bb* * * * #
####################