####################
#   ** **  * * **o #
# # # #*# # # # # *#
# * * *b  ** * * * #
#*#* # # # # # # # #
# *** * *  * * * * #
# # # # # # # # # *#
# * *o* **** * * * #
#* # # # # # # # # #
# * * * *  * *o* * #
# # # # # # # # # *#
# * * * * ** * * * #
#* # # # # # # # # #
#x*o* * * b* * * * #
####################